"","cod_muni","muni","arroz_em_casca_1","milho_em_grao_1","soja_em_grao_1","valor_producao","class_valor_producao"
"1",1100015,"Alta Floresta D'Oeste (RO)",0,1740,0,1740,"Médio Alto"
"2",1100023,"Ariquemes (RO)",0,255,2164,2419,"Médio Alto"
"3",1100031,"Cabixi (RO)",0,8844,17602,26446,"Médio Alto"
"4",1100056,"Cerejeiras (RO)",1319,25839,69227,96385,"Alto"
"5",1100072,"Corumbiara (RO)",0,38131,116861,154992,"Alto"
"6",1100080,"Costa Marques (RO)",0,43,0,43,"Baixo"
"7",1100114,"Jaru (RO)",0,74,0,74,"Médio Baixo"
"8",1100122,"Ji-Paraná (RO)",0,26,0,26,"Baixo"
"9",1100205,"Porto Velho (RO)",0,339,0,339,"Médio Baixo"
"10",1100254,"Presidente Médici (RO)",0,70,0,70,"Médio Baixo"
"11",1100262,"Rio Crespo (RO)",0,0,6236,6236,"Médio Alto"
"12",1100288,"Rolim de Moura (RO)",0,599,0,599,"Médio Baixo"
"13",1100296,"Santa Luzia D'Oeste (RO)",0,4508,0,4508,"Médio Alto"
"14",1100304,"Vilhena (RO)",0,33113,96323,129436,"Alto"
"15",1100320,"São Miguel do Guaporé (RO)",12243,1635,17822,31700,"Médio Alto"
"16",1100379,"Alto Alegre dos Parecis (RO)",0,132,0,132,"Médio Baixo"
"17",1100403,"Alto Paraíso (RO)",0,35,2396,2431,"Médio Alto"
"18",1100452,"Buritis (RO)",0,15,0,15,"Muito Baixo"
"19",1100601,"Cacaulândia (RO)",0,81,0,81,"Médio Baixo"
"20",1100700,"Campo Novo de Rondônia (RO)",0,10,0,10,"Muito Baixo"
"21",1100924,"Chupinguaia (RO)",0,11881,22966,34847,"Alto"
"22",1101468,"Pimenteiras do Oeste (RO)",0,14612,30122,44734,"Alto"
"23",1101492,"São Francisco do Guaporé (RO)",0,10,0,10,"Muito Baixo"
"24",1200013,"Acrelândia (AC)",5,383,0,388,"Médio Baixo"
"25",1200054,"Assis Brasil (AC)",64,185,0,249,"Médio Baixo"
"26",1200104,"Brasiléia (AC)",176,1005,0,1181,"Médio Alto"
"27",1200138,"Bujari (AC)",0,82,0,82,"Médio Baixo"
"28",1200179,"Capixaba (AC)",27,122,0,149,"Médio Baixo"
"29",1200252,"Epitaciolândia (AC)",111,508,0,619,"Médio Baixo"
"30",1200302,"Feijó (AC)",6,545,0,551,"Médio Baixo"
"31",1200344,"Manoel Urbano (AC)",0,165,0,165,"Médio Baixo"
"32",1200385,"Plácido de Castro (AC)",0,275,0,275,"Médio Baixo"
"33",1200401,"Rio Branco (AC)",91,3573,0,3664,"Médio Alto"
"34",1200427,"Rodrigues Alves (AC)",0,1,0,1,"Muito Baixo"
"35",1200435,"Santa Rosa do Purus (AC)",0,15,0,15,"Muito Baixo"
"36",1200450,"Senador Guiomard (AC)",0,2364,0,2364,"Médio Alto"
"37",1200500,"Sena Madureira (AC)",40,347,0,387,"Médio Baixo"
"38",1200609,"Tarauacá (AC)",0,191,0,191,"Médio Baixo"
"39",1200708,"Xapuri (AC)",370,1176,0,1546,"Médio Alto"
"40",1200807,"Porto Acre (AC)",2,5948,0,5950,"Médio Alto"
"41",1300144,"Apuí (AM)",0,252,0,252,"Médio Baixo"
"42",1300631,"Beruri (AM)",0,21,0,21,"Baixo"
"43",1300706,"Boca do Acre (AM)",18,182,0,200,"Médio Baixo"
"44",1300904,"Canutama (AM)",0,11,0,11,"Muito Baixo"
"45",1301209,"Coari (AM)",0,6,0,6,"Muito Baixo"
"46",1301308,"Codajás (AM)",0,1,0,1,"Muito Baixo"
"47",1301506,"Envira (AM)",13,240,0,253,"Médio Baixo"
"48",1301704,"Humaitá (AM)",0,30,0,30,"Baixo"
"49",1301803,"Ipixuna (AM)",0,54,0,54,"Médio Baixo"
"50",1302405,"Lábrea (AM)",0,62,0,62,"Médio Baixo"
"51",1302553,"Manaquiri (AM)",0,14,0,14,"Muito Baixo"
"52",1302702,"Manicoré (AM)",0,41,0,41,"Baixo"
"53",1302900,"Maués (AM)",0,1,0,1,"Muito Baixo"
"54",1304104,"Tapauá (AM)",0,26,0,26,"Baixo"
"55",1304203,"Tefé (AM)",0,9,0,9,"Muito Baixo"
"56",1400027,"Amajari (RR)",0,48,0,48,"Baixo"
"57",1400050,"Alto Alegre (RR)",0,264,18759,19023,"Médio Alto"
"58",1400100,"Boa Vista (RR)",0,6,157,163,"Médio Baixo"
"59",1400159,"Bonfim (RR)",10735,150,8100,18985,"Médio Alto"
"60",1400175,"Cantá (RR)",0,123,0,123,"Médio Baixo"
"61",1400209,"Caracaraí (RR)",4,74,0,78,"Médio Baixo"
"62",1400233,"Caroebe (RR)",0,22,0,22,"Baixo"
"63",1400282,"Iracema (RR)",0,89,0,89,"Médio Baixo"
"64",1400308,"Mucajaí (RR)",0,34,0,34,"Baixo"
"65",1400472,"Rorainópolis (RR)",0,524,0,524,"Médio Baixo"
"66",1400704,"Uiramutã (RR)",0,4,0,4,"Muito Baixo"
"67",1500206,"Acará (PA)",47,3,0,50,"Baixo"
"68",1500305,"Afuá (PA)",0,35,0,35,"Baixo"
"69",1500347,"Água Azul do Norte (PA)",0,5674,0,5674,"Médio Alto"
"70",1500404,"Alenquer (PA)",0,146,0,146,"Médio Baixo"
"71",1500503,"Almeirim (PA)",0,36,0,36,"Baixo"
"72",1500602,"Altamira (PA)",9235,6645,18361,34241,"Alto"
"73",1500859,"Anapu (PA)",17,148,0,165,"Médio Baixo"
"74",1500958,"Aurora do Pará (PA)",0,3,0,3,"Muito Baixo"
"75",1501006,"Aveiro (PA)",0,124,0,124,"Médio Baixo"
"76",1501451,"Belterra (PA)",0,7128,10133,17261,"Médio Alto"
"77",1501576,"Bom Jesus do Tocantins (PA)",0,166,0,166,"Médio Baixo"
"78",1501709,"Bragança (PA)",0,60,0,60,"Médio Baixo"
"79",1501725,"Brasil Novo (PA)",0,239,0,239,"Médio Baixo"
"80",1501758,"Brejo Grande do Araguaia (PA)",0,16,0,16,"Baixo"
"81",1501782,"Breu Branco (PA)",9,37,0,46,"Baixo"
"82",1501808,"Breves (PA)",2,5,0,7,"Muito Baixo"
"83",1501956,"Cachoeira do Piriá (PA)",30,21,0,51,"Baixo"
"84",1502103,"Cametá (PA)",2,0,0,2,"Muito Baixo"
"85",1502152,"Canaã dos Carajás (PA)",0,510,0,510,"Médio Baixo"
"86",1502301,"Capitão Poço (PA)",0,44,0,44,"Baixo"
"87",1502509,"Chaves (PA)",0,29,0,29,"Baixo"
"88",1502707,"Conceição do Araguaia (PA)",61,567,0,628,"Médio Alto"
"89",1502764,"Cumaru do Norte (PA)",0,9,0,9,"Muito Baixo"
"90",1502772,"Curionópolis (PA)",0,70,0,70,"Médio Baixo"
"91",1502939,"Dom Eliseu (PA)",0,15382,102009,117391,"Alto"
"92",1502954,"Eldorado do Carajás (PA)",36,171,0,207,"Médio Baixo"
"93",1503044,"Floresta do Araguaia (PA)",0,4,0,4,"Muito Baixo"
"94",1503093,"Goianésia do Pará (PA)",0,48,0,48,"Baixo"
"95",1503457,"Ipixuna do Pará (PA)",129,448,5042,5619,"Médio Alto"
"96",1503606,"Itaituba (PA)",10,124,0,134,"Médio Baixo"
"97",1503705,"Itupiranga (PA)",4,701,0,705,"Médio Alto"
"98",1504208,"Marabá (PA)",18,1909,0,1927,"Médio Alto"
"99",1504455,"Medicilândia (PA)",12,65,0,77,"Médio Baixo"
"100",1504703,"Moju (PA)",18,966,0,984,"Médio Alto"
"101",1504752,"Mojuí dos Campos (PA)",0,474,29779,30253,"Médio Alto"
"102",1504802,"Monte Alegre (PA)",6,128,0,134,"Médio Baixo"
"103",1504950,"Nova Esperança do Piriá (PA)",235,488,0,723,"Médio Alto"
"104",1504976,"Nova Ipixuna (PA)",0,8,0,8,"Muito Baixo"
"105",1505031,"Novo Progresso (PA)",2348,1168,16366,19882,"Médio Alto"
"106",1505064,"Novo Repartimento (PA)",40,641,0,681,"Médio Alto"
"107",1505106,"Óbidos (PA)",0,50,0,50,"Baixo"
"108",1505304,"Oriximiná (PA)",1,52,0,53,"Baixo"
"109",1505437,"Ourilândia do Norte (PA)",0,101,0,101,"Médio Baixo"
"110",1505486,"Pacajá (PA)",117,202,0,319,"Médio Baixo"
"111",1505494,"Palestina do Pará (PA)",0,82,0,82,"Médio Baixo"
"112",1505502,"Paragominas (PA)",1602,28332,176165,206099,"Muito Alto"
"113",1505536,"Parauapebas (PA)",0,44,0,44,"Baixo"
"114",1505601,"Peixe-Boi (PA)",0,2,0,2,"Muito Baixo"
"115",1505635,"Piçarra (PA)",0,96,0,96,"Médio Baixo"
"116",1505650,"Placas (PA)",379,259,0,638,"Médio Alto"
"117",1505809,"Portel (PA)",15,0,0,15,"Muito Baixo"
"118",1505908,"Porto de Moz (PA)",0,24,0,24,"Baixo"
"119",1506005,"Prainha (PA)",17,13,0,30,"Baixo"
"120",1506138,"Redenção (PA)",0,655,0,655,"Médio Alto"
"121",1506161,"Rio Maria (PA)",0,841,0,841,"Médio Alto"
"122",1506187,"Rondon do Pará (PA)",0,578,37904,38482,"Alto"
"123",1506195,"Rurópolis (PA)",197,28,0,225,"Médio Baixo"
"124",1506559,"Santa Luzia do Pará (PA)",0,5,0,5,"Muito Baixo"
"125",1506583,"Santa Maria das Barreiras (PA)",14,15470,63239,78723,"Alto"
"126",1506708,"Santana do Araguaia (PA)",0,29318,166108,195426,"Muito Alto"
"127",1506807,"Santarém (PA)",0,4833,15206,20039,"Médio Alto"
"128",1507151,"São Domingos do Araguaia (PA)",0,45,0,45,"Baixo"
"129",1507201,"São Domingos do Capim (PA)",0,15,0,15,"Muito Baixo"
"130",1507300,"São Félix do Xingu (PA)",11,6247,0,6258,"Médio Alto"
"131",1507458,"São Geraldo do Araguaia (PA)",0,78,0,78,"Médio Baixo"
"132",1507508,"São João do Araguaia (PA)",0,3,0,3,"Muito Baixo"
"133",1507805,"Senador José Porfírio (PA)",14,88,0,102,"Médio Baixo"
"134",1507953,"Tailândia (PA)",44,11211,0,11255,"Médio Alto"
"135",1508050,"Trairão (PA)",0,417,0,417,"Médio Baixo"
"136",1508084,"Tucumã (PA)",0,2309,0,2309,"Médio Alto"
"137",1508100,"Tucuruí (PA)",0,7,0,7,"Muito Baixo"
"138",1508126,"Ulianópolis (PA)",259,10614,31149,42022,"Alto"
"139",1508159,"Uruará (PA)",27,1331,0,1358,"Médio Alto"
"140",1508308,"Viseu (PA)",3,20,0,23,"Baixo"
"141",1508407,"Xinguara (PA)",0,93,0,93,"Médio Baixo"
"142",1600279,"Laranjal do Jari (AP)",0,16,0,16,"Baixo"
"143",1600303,"Macapá (AP)",0,0,6083,6083,"Médio Alto"
"144",1600402,"Mazagão (AP)",0,19,0,19,"Baixo"
"145",1600501,"Oiapoque (AP)",0,1,0,1,"Muito Baixo"
"146",1600550,"Pracuúba (AP)",0,2,0,2,"Muito Baixo"
"147",1600808,"Vitória do Jari (AP)",0,4,0,4,"Muito Baixo"
"148",1700251,"Abreulândia (TO)",0,0,1003,1003,"Médio Alto"
"149",1700301,"Aguiarnópolis (TO)",0,47,0,47,"Baixo"
"150",1700350,"Aliança do Tocantins (TO)",0,8,2658,2666,"Médio Alto"
"151",1700400,"Almas (TO)",20,89,3330,3439,"Médio Alto"
"152",1700707,"Alvorada (TO)",0,0,35941,35941,"Alto"
"153",1701101,"Aparecida do Rio Negro (TO)",0,245,52819,53064,"Alto"
"154",1701903,"Araguacema (TO)",0,4,9310,9314,"Médio Alto"
"155",1702000,"Araguaçu (TO)",0,1593,11895,13488,"Médio Alto"
"156",1702109,"Araguaína (TO)",0,12,0,12,"Muito Baixo"
"157",1702208,"Araguatins (TO)",26,1261,0,1287,"Médio Alto"
"158",1702307,"Arapoema (TO)",0,1271,0,1271,"Médio Alto"
"159",1702406,"Arraias (TO)",22,311,0,333,"Médio Baixo"
"160",1702554,"Augustinópolis (TO)",0,9,0,9,"Muito Baixo"
"161",1703008,"Babaçulândia (TO)",0,51,0,51,"Baixo"
"162",1703073,"Barra do Ouro (TO)",21,65,0,86,"Médio Baixo"
"163",1703305,"Bom Jesus do Tocantins (TO)",11,3702,2797,6510,"Médio Alto"
"164",1703701,"Brejinho de Nazaré (TO)",0,3674,44419,48093,"Alto"
"165",1703842,"Campos Lindos (TO)",285,75458,179920,255663,"Muito Alto"
"166",1703867,"Cariri do Tocantins (TO)",0,553,50987,51540,"Alto"
"167",1703909,"Caseara (TO)",0,7570,26182,33752,"Alto"
"168",1704105,"Centenário (TO)",221,85,0,306,"Médio Baixo"
"169",1705102,"Chapada da Natividade (TO)",12,44,0,56,"Médio Baixo"
"170",1705607,"Conceição do Tocantins (TO)",28,127,0,155,"Médio Baixo"
"171",1706001,"Couto Magalhães (TO)",7,2825,0,2832,"Médio Alto"
"172",1706100,"Cristalândia (TO)",3108,57,0,3165,"Médio Alto"
"173",1706506,"Darcinópolis (TO)",55,3131,9033,12219,"Médio Alto"
"174",1707009,"Dianópolis (TO)",0,43,0,43,"Baixo"
"175",1707207,"Dois Irmãos do Tocantins (TO)",10,0,0,10,"Muito Baixo"
"176",1707306,"Dueré (TO)",6704,5,0,6709,"Médio Alto"
"177",1707652,"Figueirópolis (TO)",0,1107,15102,16209,"Médio Alto"
"178",1707702,"Filadélfia (TO)",0,9,0,9,"Muito Baixo"
"179",1708205,"Formoso do Araguaia (TO)",72206,1527,13742,87475,"Alto"
"180",1708304,"Goianorte (TO)",0,90,0,90,"Médio Baixo"
"181",1709005,"Goiatins (TO)",383,1679,5241,7303,"Médio Alto"
"182",1709302,"Guaraí (TO)",0,3007,14760,17767,"Médio Alto"
"183",1709500,"Gurupi (TO)",7,6,32424,32437,"Alto"
"184",1710508,"Itacajá (TO)",27,1376,9487,10890,"Médio Alto"
"185",1710706,"Itaguatins (TO)",17,15,0,32,"Baixo"
"186",1710904,"Itapiratins (TO)",0,20411,23981,44392,"Alto"
"187",1711506,"Jaú do Tocantins (TO)",0,117,0,117,"Médio Baixo"
"188",1711902,"Lagoa da Confusão (TO)",105767,74,47114,152955,"Alto"
"189",1711951,"Lagoa do Tocantins (TO)",0,5,0,5,"Muito Baixo"
"190",1712405,"Lizarda (TO)",31,12,0,43,"Baixo"
"191",1712504,"Marianópolis do Tocantins (TO)",0,0,40543,40543,"Alto"
"192",1712702,"Mateiros (TO)",5,11657,46978,58640,"Alto"
"193",1713205,"Miracema do Tocantins (TO)",0,1346,4978,6324,"Médio Alto"
"194",1713304,"Miranorte (TO)",30,0,1407,1437,"Médio Alto"
"195",1713601,"Monte do Carmo (TO)",0,48,63307,63355,"Alto"
"196",1713809,"Palmeiras do Tocantins (TO)",0,118,0,118,"Médio Baixo"
"197",1714203,"Natividade (TO)",11,6,0,17,"Baixo"
"198",1714880,"Nova Olinda (TO)",0,10,0,10,"Muito Baixo"
"199",1715101,"Novo Acordo (TO)",0,663,3643,4306,"Médio Alto"
"200",1715259,"Novo Jardim (TO)",0,20,0,20,"Baixo"
"201",1715705,"Palmeirante (TO)",0,345,7584,7929,"Médio Alto"
"202",1715754,"Palmeirópolis (TO)",11,428,0,439,"Médio Baixo"
"203",1716109,"Paraíso do Tocantins (TO)",0,656,0,656,"Médio Alto"
"204",1716208,"Paranã (TO)",73,195,0,268,"Médio Baixo"
"205",1716505,"Pedro Afonso (TO)",0,3862,22676,26538,"Médio Alto"
"206",1716604,"Peixe (TO)",32,4446,113762,118240,"Alto"
"207",1717008,"Pindorama do Tocantins (TO)",22,58,0,80,"Médio Baixo"
"208",1717503,"Pium (TO)",27047,4706,10688,42441,"Alto"
"209",1717800,"Ponte Alta do Bom Jesus (TO)",19,15,0,34,"Baixo"
"210",1717909,"Ponte Alta do Tocantins (TO)",0,90,0,90,"Médio Baixo"
"211",1718006,"Porto Alegre do Tocantins (TO)",0,123,0,123,"Médio Baixo"
"212",1718204,"Porto Nacional (TO)",3,13794,71167,84964,"Alto"
"213",1718501,"Recursolândia (TO)",49,9,0,58,"Médio Baixo"
"214",1718709,"Rio dos Bois (TO)",0,2851,12665,15516,"Médio Alto"
"215",1718758,"Rio Sono (TO)",116,633,0,749,"Médio Alto"
"216",1718865,"Santa Fé do Araguaia (TO)",0,3488,11336,14824,"Médio Alto"
"217",1718881,"Santa Maria do Tocantins (TO)",0,33,2437,2470,"Médio Alto"
"218",1718899,"Santa Rita do Tocantins (TO)",0,0,12625,12625,"Médio Alto"
"219",1718907,"Santa Rosa do Tocantins (TO)",0,280,58400,58680,"Alto"
"220",1720101,"São Bento do Tocantins (TO)",18,51,0,69,"Médio Baixo"
"221",1720150,"São Félix do Tocantins (TO)",0,2,0,2,"Muito Baixo"
"222",1720259,"São Salvador do Tocantins (TO)",0,8,0,8,"Muito Baixo"
"223",1720499,"São Valério (TO)",0,909,14478,15387,"Médio Alto"
"224",1720655,"Silvanópolis (TO)",13,7037,32297,39347,"Alto"
"225",1720804,"Sítio Novo do Tocantins (TO)",0,8,0,8,"Muito Baixo"
"226",1720853,"Sucupira (TO)",0,441,12593,13034,"Médio Alto"
"227",1720903,"Taguatinga (TO)",9,98,0,107,"Médio Baixo"
"228",1720978,"Talismã (TO)",6,34,19141,19181,"Médio Alto"
"229",1721000,"Palmas (TO)",0,4109,18699,22808,"Médio Alto"
"230",1721257,"Tupirama (TO)",0,349,10648,10997,"Médio Alto"
"231",1721307,"Tupiratins (TO)",0,263,0,263,"Médio Baixo"
"232",2100055,"Açailândia (MA)",0,11384,69211,80595,"Alto"
"233",2100402,"Altamira do Maranhão (MA)",4,0,0,4,"Muito Baixo"
"234",2100477,"Alto Alegre do Pindaré (MA)",0,38,0,38,"Baixo"
"235",2100501,"Alto Parnaíba (MA)",112,2489,30561,33162,"Alto"
"236",2100600,"Amarante do Maranhão (MA)",65,706,0,771,"Médio Alto"
"237",2100956,"Arame (MA)",113,1592,0,1705,"Médio Alto"
"238",2101004,"Arari (MA)",20,14,0,34,"Baixo"
"239",2101202,"Bacabal (MA)",9,62,0,71,"Médio Baixo"
"240",2101400,"Balsas (MA)",1107,217660,452423,671190,"Muito Alto"
"241",2101608,"Barra do Corda (MA)",38,325,0,363,"Médio Baixo"
"242",2101806,"Benedito Leite (MA)",114,75,0,189,"Médio Baixo"
"243",2102002,"Bom Jardim (MA)",21,468,0,489,"Médio Baixo"
"244",2102036,"Bom Jesus das Selvas (MA)",0,736,0,736,"Médio Alto"
"245",2102077,"Bom Lugar (MA)",19,9,0,28,"Baixo"
"246",2102150,"Brejo de Areia (MA)",37,42,0,79,"Médio Baixo"
"247",2102309,"Buriti Bravo (MA)",14,147,0,161,"Médio Baixo"
"248",2102325,"Buriticupu (MA)",35,585,15272,15892,"Médio Alto"
"249",2102358,"Buritirana (MA)",4,156,0,160,"Médio Baixo"
"250",2102556,"Campestre do Maranhão (MA)",0,123,0,123,"Médio Baixo"
"251",2102804,"Carolina (MA)",751,22281,0,23032,"Médio Alto"
"252",2102903,"Carutapera (MA)",12,12,0,24,"Baixo"
"253",2103000,"Caxias (MA)",66,439,0,505,"Médio Baixo"
"254",2103158,"Centro do Guilherme (MA)",0,9,0,9,"Muito Baixo"
"255",2103174,"Centro Novo do Maranhão (MA)",0,6,0,6,"Muito Baixo"
"256",2103257,"Cidelândia (MA)",0,115,0,115,"Médio Baixo"
"257",2103307,"Codó (MA)",111,198,0,309,"Médio Baixo"
"258",2103505,"Colinas (MA)",3,118,0,121,"Médio Baixo"
"259",2103604,"Coroatá (MA)",43,103,0,146,"Médio Baixo"
"260",2103802,"Dom Pedro (MA)",0,30,0,30,"Baixo"
"261",2104008,"Esperantinópolis (MA)",5,19,0,24,"Baixo"
"262",2104057,"Estreito (MA)",57,115,0,172,"Médio Baixo"
"263",2104073,"Feira Nova do Maranhão (MA)",220,379,0,599,"Médio Baixo"
"264",2104081,"Fernando Falcão (MA)",37,12,0,49,"Baixo"
"265",2104099,"Formosa da Serra Negra (MA)",303,369,0,672,"Médio Alto"
"266",2104107,"Fortaleza dos Nogueiras (MA)",286,4081,0,4367,"Médio Alto"
"267",2104206,"Fortuna (MA)",20,745,0,765,"Médio Alto"
"268",2104404,"Gonçalves Dias (MA)",55,52,0,107,"Médio Baixo"
"269",2104552,"Governador Edison Lobão (MA)",0,48,0,48,"Baixo"
"270",2104602,"Governador Eugênio Barros (MA)",0,109,0,109,"Médio Baixo"
"271",2104628,"Governador Luiz Rocha (MA)",0,1317,0,1317,"Médio Alto"
"272",2104651,"Governador Newton Bello (MA)",12,14,0,26,"Baixo"
"273",2104677,"Governador Nunes Freire (MA)",0,14,0,14,"Muito Baixo"
"274",2104701,"Graça Aranha (MA)",21,23,0,44,"Baixo"
"275",2104800,"Grajaú (MA)",2509,7182,25226,34917,"Alto"
"276",2105302,"Imperatriz (MA)",0,39,0,39,"Baixo"
"277",2105351,"Itaipava do Grajaú (MA)",20,120,0,140,"Médio Baixo"
"278",2105427,"Itinga do Maranhão (MA)",0,1047,8866,9913,"Médio Alto"
"279",2105450,"Jatobá (MA)",0,105,0,105,"Médio Baixo"
"280",2105476,"Jenipapo dos Vieiras (MA)",13,61,0,74,"Médio Baixo"
"281",2105609,"Joselândia (MA)",0,18,0,18,"Baixo"
"282",2105658,"Junco do Maranhão (MA)",3,4,0,7,"Muito Baixo"
"283",2105708,"Lago da Pedra (MA)",23,51,0,74,"Médio Baixo"
"284",2105807,"Lago do Junco (MA)",0,185,0,185,"Médio Baixo"
"285",2105948,"Lago dos Rodrigues (MA)",0,187,0,187,"Médio Baixo"
"286",2105963,"Lagoa Grande do Maranhão (MA)",6,43,0,49,"Baixo"
"287",2105989,"Lajeado Novo (MA)",51,435,0,486,"Médio Baixo"
"288",2106102,"Loreto (MA)",770,24414,103894,129078,"Alto"
"289",2106359,"Marajá do Sena (MA)",51,49,0,100,"Médio Baixo"
"290",2106631,"Matões do Norte (MA)",152,0,0,152,"Médio Baixo"
"291",2106706,"Mirador (MA)",110,90,0,200,"Médio Baixo"
"292",2107001,"Montes Altos (MA)",5,3312,0,3317,"Médio Alto"
"293",2107258,"Nova Colinas (MA)",10,1321,0,1331,"Médio Alto"
"294",2107308,"Nova Iorque (MA)",13,233,0,246,"Médio Baixo"
"295",2107357,"Nova Olinda do Maranhão (MA)",0,10,0,10,"Muito Baixo"
"296",2107704,"Paraibano (MA)",89,652,0,741,"Médio Alto"
"297",2108009,"Pastos Bons (MA)",204,3057,0,3261,"Médio Alto"
"298",2108108,"Paulo Ramos (MA)",33,49,0,82,"Médio Baixo"
"299",2108256,"Pedro do Rosário (MA)",9,11,0,20,"Baixo"
"300",2108454,"Peritoró (MA)",14,64,0,78,"Médio Baixo"
"301",2108603,"Pinheiro (MA)",0,2,0,2,"Muito Baixo"
"302",2108702,"Pio XII (MA)",4,10,0,14,"Muito Baixo"
"303",2108900,"Poção de Pedras (MA)",9,54,0,63,"Médio Baixo"
"304",2109007,"Porto Franco (MA)",43,348,0,391,"Médio Baixo"
"305",2109106,"Presidente Dutra (MA)",10,137,0,147,"Médio Baixo"
"306",2109502,"Riachão (MA)",399,29394,76381,106174,"Alto"
"307",2109700,"Sambaíba (MA)",42,37645,87149,124836,"Alto"
"308",2109759,"Santa Filomena do Maranhão (MA)",10,27,0,37,"Baixo"
"309",2110005,"Santa Luzia (MA)",110,5812,0,5922,"Médio Alto"
"310",2110302,"Santo Antônio dos Lopes (MA)",0,17,0,17,"Baixo"
"311",2110658,"São Domingos do Azeitão (MA)",2432,1760,74794,78986,"Alto"
"312",2110708,"São Domingos do Maranhão (MA)",15,286,0,301,"Médio Baixo"
"313",2110807,"São Félix de Balsas (MA)",33,116,0,149,"Médio Baixo"
"314",2110856,"São Francisco do Brejão (MA)",0,1445,0,1445,"Médio Alto"
"315",2111052,"São João do Paraíso (MA)",56,200,0,256,"Médio Baixo"
"316",2111078,"São João do Soter (MA)",5,69,0,74,"Médio Baixo"
"317",2111250,"São José dos Basílios (MA)",0,24,0,24,"Baixo"
"318",2111409,"São Luís Gonzaga do Maranhão (MA)",12,5,0,17,"Baixo"
"319",2111508,"São Mateus do Maranhão (MA)",4020,0,0,4020,"Médio Alto"
"320",2111573,"São Pedro dos Crentes (MA)",35,118,0,153,"Médio Baixo"
"321",2111607,"São Raimundo das Mangabeiras (MA)",68,665,0,733,"Médio Alto"
"322",2111631,"São Raimundo do Doca Bezerra (MA)",11,55,0,66,"Médio Baixo"
"323",2111722,"Satubinha (MA)",0,16,0,16,"Baixo"
"324",2111748,"Senador Alexandre Costa (MA)",0,27,0,27,"Baixo"
"325",2111763,"Senador La Rocque (MA)",0,5,0,5,"Muito Baixo"
"326",2111805,"Sítio Novo (MA)",131,1141,0,1272,"Médio Alto"
"327",2111904,"Sucupira do Norte (MA)",17,59,0,76,"Médio Baixo"
"328",2112001,"Tasso Fragoso (MA)",48,79055,19977,99080,"Alto"
"329",2112100,"Timbiras (MA)",30,18,0,48,"Baixo"
"330",2112308,"Tuntum (MA)",21,1592,0,1613,"Médio Alto"
"331",2112456,"Turilândia (MA)",0,16,0,16,"Baixo"
"332",2112704,"Vargem Grande (MA)",8,0,0,8,"Muito Baixo"
"333",2112902,"Vitória do Mearim (MA)",913,12,0,925,"Médio Alto"
"334",2113009,"Vitorino Freire (MA)",0,25,0,25,"Baixo"
"335",2114007,"Zé Doca (MA)",25,14,0,39,"Baixo"
"336",5100201,"Água Boa (MT)",0,27618,308399,336017,"Muito Alto"
"337",5100250,"Alta Floresta (MT)",0,7484,28013,35497,"Alto"
"338",5100300,"Alto Araguaia (MT)",0,8719,66786,75505,"Alto"
"339",5100359,"Alto Boa Vista (MT)",0,0,2299,2299,"Médio Alto"
"340",5100409,"Alto Garças (MT)",0,38218,160681,198899,"Muito Alto"
"341",5100607,"Alto Taquari (MT)",0,52395,58336,110731,"Alto"
"342",5101258,"Araputanga (MT)",0,644,0,644,"Médio Alto"
"343",5101308,"Arenápolis (MT)",0,367,0,367,"Médio Baixo"
"344",5101407,"Aripuanã (MT)",0,984,690,1674,"Médio Alto"
"345",5101803,"Barra do Garças (MT)",0,0,76445,76445,"Alto"
"346",5101852,"Bom Jesus do Araguaia (MT)",0,16848,306965,323813,"Muito Alto"
"347",5101902,"Brasnorte (MT)",12284,161445,688793,862522,"Muito Alto"
"348",5102504,"Cáceres (MT)",0,10268,0,10268,"Médio Alto"
"349",5102603,"Campinápolis (MT)",0,289,45238,45527,"Alto"
"350",5102637,"Campo Novo do Parecis (MT)",0,174092,677392,851484,"Muito Alto"
"351",5102678,"Campo Verde (MT)",0,172971,421770,594741,"Muito Alto"
"352",5102686,"Campos de Júlio (MT)",0,122110,508088,630198,"Muito Alto"
"353",5102694,"Canabrava do Norte (MT)",0,19674,7237,26911,"Médio Alto"
"354",5102702,"Canarana (MT)",0,62944,610181,673125,"Muito Alto"
"355",5102793,"Carlinda (MT)",0,4620,0,4620,"Médio Alto"
"356",5102850,"Castanheira (MT)",0,6,0,6,"Muito Baixo"
"357",5103007,"Chapada dos Guimarães (MT)",0,14139,53598,67737,"Alto"
"358",5103056,"Cláudia (MT)",781,68693,244802,314276,"Muito Alto"
"359",5103106,"Cocalinho (MT)",0,630,0,630,"Médio Alto"
"360",5103205,"Colíder (MT)",0,8287,6018,14305,"Médio Alto"
"361",5103254,"Colniza (MT)",0,28,0,28,"Baixo"
"362",5103304,"Comodoro (MT)",0,4215,156064,160279,"Muito Alto"
"363",5103353,"Confresa (MT)",0,23578,66041,89619,"Alto"
"364",5103379,"Cotriguaçu (MT)",0,90,0,90,"Médio Baixo"
"365",5103502,"Diamantino (MT)",0,209717,642960,852677,"Muito Alto"
"366",5103601,"Dom Aquino (MT)",0,22972,82110,105082,"Alto"
"367",5103700,"Feliz Natal (MT)",1890,79000,242705,323595,"Muito Alto"
"368",5103858,"Gaúcha do Norte (MT)",0,33030,500498,533528,"Muito Alto"
"369",5103908,"General Carneiro (MT)",0,26749,165709,192458,"Muito Alto"
"370",5104104,"Guarantã do Norte (MT)",1183,7122,21819,30124,"Médio Alto"
"371",5104203,"Guiratinga (MT)",0,18182,130009,148191,"Alto"
"372",5104526,"Ipiranga do Norte (MT)",0,150824,671758,822582,"Muito Alto"
"373",5104542,"Itanhangá (MT)",0,31875,121112,152987,"Alto"
"374",5104559,"Itaúba (MT)",0,7766,87991,95757,"Alto"
"375",5104609,"Itiquira (MT)",0,147862,464366,612228,"Muito Alto"
"376",5104807,"Jaciara (MT)",0,41876,113348,155224,"Alto"
"377",5105101,"Juara (MT)",28712,1875,70594,101181,"Alto"
"378",5105150,"Juína (MT)",0,1352,5092,6444,"Médio Alto"
"379",5105176,"Juruena (MT)",0,18,0,18,"Baixo"
"380",5105200,"Juscimeira (MT)",0,2488,9504,11992,"Médio Alto"
"381",5105259,"Lucas do Rio Verde (MT)",2097,214747,525036,741880,"Muito Alto"
"382",5105507,"Vila Bela da Santíssima Trindade (MT)",0,18282,46100,64382,"Alto"
"383",5105580,"Marcelândia (MT)",3719,21937,126939,152595,"Alto"
"384",5105606,"Matupá (MT)",0,35218,42756,77974,"Alto"
"385",5105903,"Nobres (MT)",0,10253,104161,114414,"Alto"
"386",5106000,"Nortelândia (MT)",0,2570,10233,12803,"Médio Alto"
"387",5106109,"Nossa Senhora do Livramento (MT)",0,160,0,160,"Médio Baixo"
"388",5106158,"Nova Bandeirantes (MT)",0,26,0,26,"Baixo"
"389",5106174,"Nova Nazaré (MT)",0,0,19415,19415,"Médio Alto"
"390",5106182,"Nova Lacerda (MT)",0,4127,4561,8688,"Médio Alto"
"391",5106190,"Nova Santa Helena (MT)",0,1899,42306,44205,"Alto"
"392",5106216,"Nova Canaã do Norte (MT)",5113,1674,73473,80260,"Alto"
"393",5106224,"Nova Mutum (MT)",0,450970,934732,1385702,"Muito Alto"
"394",5106240,"Nova Ubiratã (MT)",5501,291526,1024951,1321978,"Muito Alto"
"395",5106257,"Nova Xavantina (MT)",0,17126,92138,109264,"Alto"
"396",5106265,"Novo Mundo (MT)",889,17024,42334,60247,"Alto"
"397",5106281,"Novo São Joaquim (MT)",0,60106,218803,278909,"Muito Alto"
"398",5106299,"Paranaíta (MT)",0,39,0,39,"Baixo"
"399",5106307,"Paranatinga (MT)",9225,83535,718508,811268,"Muito Alto"
"400",5106372,"Pedra Preta (MT)",0,35811,139106,174917,"Muito Alto"
"401",5106422,"Peixoto de Azevedo (MT)",0,3296,54129,57425,"Alto"
"402",5106455,"Planalto da Serra (MT)",0,0,13833,13833,"Médio Alto"
"403",5106505,"Poconé (MT)",0,0,12668,12668,"Médio Alto"
"404",5106752,"Pontes e Lacerda (MT)",0,11181,12957,24138,"Médio Alto"
"405",5106778,"Porto Alegre do Norte (MT)",0,14967,13553,28520,"Médio Alto"
"406",5106802,"Porto dos Gaúchos (MT)",9522,156330,518881,684733,"Muito Alto"
"407",5106828,"Porto Esperidião (MT)",0,72,0,72,"Médio Baixo"
"408",5107008,"Poxoréu (MT)",0,73169,152038,225207,"Muito Alto"
"409",5107040,"Primavera do Leste (MT)",0,276414,791702,1068116,"Muito Alto"
"410",5107065,"Querência (MT)",0,286752,467398,754150,"Muito Alto"
"411",5107180,"Ribeirão Cascalheira (MT)",235,5372,156390,161997,"Muito Alto"
"412",5107248,"Santa Carmem (MT)",0,40541,284335,324876,"Muito Alto"
"413",5107305,"São José do Rio Claro (MT)",0,43988,220444,264432,"Muito Alto"
"414",5107354,"São José do Xingu (MT)",0,13409,98730,112139,"Alto"
"415",5107578,"Rondolândia (MT)",0,123,0,123,"Médio Baixo"
"416",5107602,"Rondonópolis (MT)",0,93983,17703,111686,"Alto"
"417",5107701,"Rosário Oeste (MT)",0,2465,68340,70805,"Alto"
"418",5107743,"Santa Cruz do Xingu (MT)",0,716,46339,47055,"Alto"
"419",5107768,"Santa Rita do Trivelato (MT)",0,106683,350494,457177,"Muito Alto"
"420",5107776,"Santa Terezinha (MT)",0,11849,0,11849,"Médio Alto"
"421",5107792,"Santo Antônio do Leste (MT)",0,81707,181443,263150,"Muito Alto"
"422",5107800,"Santo Antônio do Leverger (MT)",0,15732,43379,59111,"Alto"
"423",5107859,"São Félix do Araguaia (MT)",0,0,657010,657010,"Muito Alto"
"424",5107875,"Sapezal (MT)",0,334834,1184572,1519406,"Muito Alto"
"425",5107909,"Sinop (MT)",0,164495,446800,611295,"Muito Alto"
"426",5107925,"Sorriso (MT)",11552,656741,1859755,2528048,"Muito Alto"
"427",5107941,"Tabaporã (MT)",32954,60735,283843,377532,"Muito Alto"
"428",5107958,"Tangará da Serra (MT)",0,47584,187990,235574,"Muito Alto"
"429",5108006,"Tapurah (MT)",1039,130610,353564,485213,"Muito Alto"
"430",5108055,"Terra Nova do Norte (MT)",0,8246,14608,22854,"Médio Alto"
"431",5108105,"Tesouro (MT)",0,28908,84262,113170,"Alto"
"432",5108303,"União do Sul (MT)",2050,38174,81140,121364,"Alto"
"433",5108501,"Vera (MT)",0,160817,386272,547089,"Muito Alto"
"434",5108600,"Vila Rica (MT)",0,29785,46564,76349,"Alto"
"435",5108808,"Nova Guarita (MT)",0,1193,0,1193,"Médio Alto"
"436",5108907,"Nova Maringá (MT)",0,98779,284115,382894,"Muito Alto"
"437",5108956,"Nova Monte Verde (MT)",2439,0,0,2439,"Médio Alto"
"438",1100049,"Cacoal (RO)",0,0,0,0,0
"439",1100064,"Colorado do Oeste (RO)",0,0,0,0,0
"440",1100098,"Espigão D'Oeste (RO)",0,0,0,0,0
"441",1100106,"Guajará-Mirim (RO)",0,0,0,0,0
"442",1100130,"Machadinho D'Oeste (RO)",0,0,0,0,0
"443",1100148,"Nova Brasilândia D'Oeste (RO)",0,0,0,0,0
"444",1100155,"Ouro Preto do Oeste (RO)",0,0,0,0,0
"445",1100189,"Pimenta Bueno (RO)",0,0,0,0,0
"446",1100338,"Nova Mamoré (RO)",0,0,0,0,0
"447",1100346,"Alvorada D'Oeste (RO)",0,0,0,0,0
"448",1100502,"Novo Horizonte do Oeste (RO)",0,0,0,0,0
"449",1100809,"Candeias do Jamari (RO)",0,0,0,0,0
"450",1100908,"Castanheiras (RO)",0,0,0,0,0
"451",1100940,"Cujubim (RO)",0,0,0,0,0
"452",1101005,"Governador Jorge Teixeira (RO)",0,0,0,0,0
"453",1101104,"Itapuã do Oeste (RO)",0,0,0,0,0
"454",1101203,"Ministro Andreazza (RO)",0,0,0,0,0
"455",1101302,"Mirante da Serra (RO)",0,0,0,0,0
"456",1101401,"Monte Negro (RO)",0,0,0,0,0
"457",1101435,"Nova União (RO)",0,0,0,0,0
"458",1101450,"Parecis (RO)",0,0,0,0,0
"459",1101476,"Primavera de Rondônia (RO)",0,0,0,0,0
"460",1101484,"São Felipe D'Oeste (RO)",0,0,0,0,0
"461",1101500,"Seringueiras (RO)",0,0,0,0,0
"462",1101559,"Teixeirópolis (RO)",0,0,0,0,0
"463",1101609,"Theobroma (RO)",0,0,0,0,0
"464",1101708,"Urupá (RO)",0,0,0,0,0
"465",1101757,"Vale do Anari (RO)",0,0,0,0,0
"466",1101807,"Vale do Paraíso (RO)",0,0,0,0,0
"467",1200203,"Cruzeiro do Sul (AC)",0,0,0,0,0
"468",1200328,"Jordão (AC)",0,0,0,0,0
"469",1200336,"Mâncio Lima (AC)",0,0,0,0,0
"470",1200351,"Marechal Thaumaturgo (AC)",0,0,0,0,0
"471",1200393,"Porto Walter (AC)",0,0,0,0,0
"472",1300029,"Alvarães (AM)",0,0,0,0,0
"473",1300060,"Amaturá (AM)",0,0,0,0,0
"474",1300086,"Anamã (AM)",0,0,0,0,0
"475",1300102,"Anori (AM)",0,0,0,0,0
"476",1300201,"Atalaia do Norte (AM)",0,0,0,0,0
"477",1300300,"Autazes (AM)",0,0,0,0,0
"478",1300409,"Barcelos (AM)",0,0,0,0,0
"479",1300508,"Barreirinha (AM)",0,0,0,0,0
"480",1300607,"Benjamin Constant (AM)",0,0,0,0,0
"481",1300680,"Boa Vista do Ramos (AM)",0,0,0,0,0
"482",1300805,"Borba (AM)",0,0,0,0,0
"483",1300839,"Caapiranga (AM)",0,0,0,0,0
"484",1301001,"Carauari (AM)",0,0,0,0,0
"485",1301100,"Careiro (AM)",0,0,0,0,0
"486",1301159,"Careiro da Várzea (AM)",0,0,0,0,0
"487",1301407,"Eirunepé (AM)",0,0,0,0,0
"488",1301605,"Fonte Boa (AM)",0,0,0,0,0
"489",1301654,"Guajará (AM)",0,0,0,0,0
"490",1301852,"Iranduba (AM)",0,0,0,0,0
"491",1301902,"Itacoatiara (AM)",0,0,0,0,0
"492",1301951,"Itamarati (AM)",0,0,0,0,0
"493",1302009,"Itapiranga (AM)",0,0,0,0,0
"494",1302108,"Japurá (AM)",0,0,0,0,0
"495",1302207,"Juruá (AM)",0,0,0,0,0
"496",1302306,"Jutaí (AM)",0,0,0,0,0
"497",1302504,"Manacapuru (AM)",0,0,0,0,0
"498",1302603,"Manaus (AM)",0,0,0,0,0
"499",1302801,"Maraã (AM)",0,0,0,0,0
"500",1303007,"Nhamundá (AM)",0,0,0,0,0
"501",1303106,"Nova Olinda do Norte (AM)",0,0,0,0,0
"502",1303205,"Novo Airão (AM)",0,0,0,0,0
"503",1303304,"Novo Aripuanã (AM)",0,0,0,0,0
"504",1303403,"Parintins (AM)",0,0,0,0,0
"505",1303502,"Pauini (AM)",0,0,0,0,0
"506",1303536,"Presidente Figueiredo (AM)",0,0,0,0,0
"507",1303569,"Rio Preto da Eva (AM)",0,0,0,0,0
"508",1303601,"Santa Isabel do Rio Negro (AM)",0,0,0,0,0
"509",1303700,"Santo Antônio do Içá (AM)",0,0,0,0,0
"510",1303809,"São Gabriel da Cachoeira (AM)",0,0,0,0,0
"511",1303908,"São Paulo de Olivença (AM)",0,0,0,0,0
"512",1303957,"São Sebastião do Uatumã (AM)",0,0,0,0,0
"513",1304005,"Silves (AM)",0,0,0,0,0
"514",1304062,"Tabatinga (AM)",0,0,0,0,0
"515",1304237,"Tonantins (AM)",0,0,0,0,0
"516",1304260,"Uarini (AM)",0,0,0,0,0
"517",1304302,"Urucará (AM)",0,0,0,0,0
"518",1304401,"Urucurituba (AM)",0,0,0,0,0
"519",1400407,"Normandia (RR)",0,0,0,0,0
"520",1400456,"Pacaraima (RR)",0,0,0,0,0
"521",1400506,"São João da Baliza (RR)",0,0,0,0,0
"522",1400605,"São Luiz (RR)",0,0,0,0,0
"523",1500107,"Abaetetuba (PA)",0,0,0,0,0
"524",1500131,"Abel Figueiredo (PA)",0,0,0,0,0
"525",1500701,"Anajás (PA)",0,0,0,0,0
"526",1500800,"Ananindeua (PA)",0,0,0,0,0
"527",1500909,"Augusto Corrêa (PA)",0,0,0,0,0
"528",1501105,"Bagre (PA)",0,0,0,0,0
"529",1501204,"Baião (PA)",0,0,0,0,0
"530",1501253,"Bannach (PA)",0,0,0,0,0
"531",1501303,"Barcarena (PA)",0,0,0,0,0
"532",1501402,"Belém (PA)",0,0,0,0,0
"533",1501501,"Benevides (PA)",0,0,0,0,0
"534",1501600,"Bonito (PA)",0,0,0,0,0
"535",1501907,"Bujaru (PA)",0,0,0,0,0
"536",1502004,"Cachoeira do Arari (PA)",0,0,0,0,0
"537",1502202,"Capanema (PA)",0,0,0,0,0
"538",1502400,"Castanhal (PA)",0,0,0,0,0
"539",1502608,"Colares (PA)",0,0,0,0,0
"540",1502756,"Concórdia do Pará (PA)",0,0,0,0,0
"541",1502806,"Curralinho (PA)",0,0,0,0,0
"542",1502855,"Curuá (PA)",0,0,0,0,0
"543",1502905,"Curuçá (PA)",0,0,0,0,0
"544",1503002,"Faro (PA)",0,0,0,0,0
"545",1503077,"Garrafão do Norte (PA)",0,0,0,0,0
"546",1503101,"Gurupá (PA)",0,0,0,0,0
"547",1503200,"Igarapé-Açu (PA)",0,0,0,0,0
"548",1503309,"Igarapé-Miri (PA)",0,0,0,0,0
"549",1503408,"Inhangapi (PA)",0,0,0,0,0
"550",1503507,"Irituia (PA)",0,0,0,0,0
"551",1503754,"Jacareacanga (PA)",0,0,0,0,0
"552",1503804,"Jacundá (PA)",0,0,0,0,0
"553",1503903,"Juruti (PA)",0,0,0,0,0
"554",1504000,"Limoeiro do Ajuru (PA)",0,0,0,0,0
"555",1504059,"Mãe do Rio (PA)",0,0,0,0,0
"556",1504109,"Magalhães Barata (PA)",0,0,0,0,0
"557",1504307,"Maracanã (PA)",0,0,0,0,0
"558",1504406,"Marapanim (PA)",0,0,0,0,0
"559",1504422,"Marituba (PA)",0,0,0,0,0
"560",1504505,"Melgaço (PA)",0,0,0,0,0
"561",1504604,"Mocajuba (PA)",0,0,0,0,0
"562",1504901,"Muaná (PA)",0,0,0,0,0
"563",1505007,"Nova Timboteua (PA)",0,0,0,0,0
"564",1505205,"Oeiras do Pará (PA)",0,0,0,0,0
"565",1505403,"Ourém (PA)",0,0,0,0,0
"566",1505551,"Pau D'Arco (PA)",0,0,0,0,0
"567",1505700,"Ponta de Pedras (PA)",0,0,0,0,0
"568",1506104,"Primavera (PA)",0,0,0,0,0
"569",1506112,"Quatipuru (PA)",0,0,0,0,0
"570",1506203,"Salinópolis (PA)",0,0,0,0,0
"571",1506302,"Salvaterra (PA)",0,0,0,0,0
"572",1506351,"Santa Bárbara do Pará (PA)",0,0,0,0,0
"573",1506401,"Santa Cruz do Arari (PA)",0,0,0,0,0
"574",1506500,"Santa Izabel do Pará (PA)",0,0,0,0,0
"575",1506609,"Santa Maria do Pará (PA)",0,0,0,0,0
"576",1506906,"Santarém Novo (PA)",0,0,0,0,0
"577",1507003,"Santo Antônio do Tauá (PA)",0,0,0,0,0
"578",1507102,"São Caetano de Odivelas (PA)",0,0,0,0,0
"579",1507409,"São Francisco do Pará (PA)",0,0,0,0,0
"580",1507466,"São João da Ponta (PA)",0,0,0,0,0
"581",1507474,"São João de Pirabas (PA)",0,0,0,0,0
"582",1507607,"São Miguel do Guamá (PA)",0,0,0,0,0
"583",1507706,"São Sebastião da Boa Vista (PA)",0,0,0,0,0
"584",1507755,"Sapucaia (PA)",0,0,0,0,0
"585",1507904,"Soure (PA)",0,0,0,0,0
"586",1507961,"Terra Alta (PA)",0,0,0,0,0
"587",1507979,"Terra Santa (PA)",0,0,0,0,0
"588",1508001,"Tomé-Açu (PA)",0,0,0,0,0
"589",1508035,"Tracuateua (PA)",0,0,0,0,0
"590",1508209,"Vigia (PA)",0,0,0,0,0
"591",1508357,"Vitória do Xingu (PA)",0,0,0,0,0
"592",1600055,"Serra do Navio (AP)",0,0,0,0,0
"593",1600105,"Amapá (AP)",0,0,0,0,0
"594",1600154,"Pedra Branca do Amapari (AP)",0,0,0,0,0
"595",1600204,"Calçoene (AP)",0,0,0,0,0
"596",1600212,"Cutias (AP)",0,0,0,0,0
"597",1600238,"Ferreira Gomes (AP)",0,0,0,0,0
"598",1600253,"Itaubal (AP)",0,0,0,0,0
"599",1600535,"Porto Grande (AP)",0,0,0,0,0
"600",1600600,"Santana (AP)",0,0,0,0,0
"601",1600709,"Tartarugalzinho (AP)",0,0,0,0,0
"602",1701002,"Ananás (TO)",0,0,0,0,0
"603",1701051,"Angico (TO)",0,0,0,0,0
"604",1701309,"Aragominas (TO)",0,0,0,0,0
"605",1702158,"Araguanã (TO)",0,0,0,0,0
"606",1702703,"Aurora do Tocantins (TO)",0,0,0,0,0
"607",1702901,"Axixá do Tocantins (TO)",0,0,0,0,0
"608",1703057,"Bandeirantes do Tocantins (TO)",0,0,0,0,0
"609",1703107,"Barrolândia (TO)",0,0,0,0,0
"610",1703206,"Bernardo Sayão (TO)",0,0,0,0,0
"611",1703602,"Brasilândia do Tocantins (TO)",0,0,0,0,0
"612",1703800,"Buriti do Tocantins (TO)",0,0,0,0,0
"613",1703826,"Cachoeirinha (TO)",0,0,0,0,0
"614",1703883,"Carmolândia (TO)",0,0,0,0,0
"615",1703891,"Carrasco Bonito (TO)",0,0,0,0,0
"616",1704600,"Chapada de Areia (TO)",0,0,0,0,0
"617",1705508,"Colinas do Tocantins (TO)",0,0,0,0,0
"618",1705557,"Combinado (TO)",0,0,0,0,0
"619",1706258,"Crixás do Tocantins (TO)",0,0,0,0,0
"620",1707108,"Divinópolis do Tocantins (TO)",0,0,0,0,0
"621",1707405,"Esperantina (TO)",0,0,0,0,0
"622",1707553,"Fátima (TO)",0,0,0,0,0
"623",1708254,"Fortaleza do Tabocão (TO)",0,0,0,0,0
"624",1709807,"Ipueiras (TO)",0,0,0,0,0
"625",1711100,"Itaporã do Tocantins (TO)",0,0,0,0,0
"626",1711803,"Juarina (TO)",0,0,0,0,0
"627",1712009,"Lajeado (TO)",0,0,0,0,0
"628",1712157,"Lavandeira (TO)",0,0,0,0,0
"629",1712454,"Luzinópolis (TO)",0,0,0,0,0
"630",1712801,"Maurilândia do Tocantins (TO)",0,0,0,0,0
"631",1713700,"Monte Santo do Tocantins (TO)",0,0,0,0,0
"632",1713957,"Muricilândia (TO)",0,0,0,0,0
"633",1714302,"Nazaré (TO)",0,0,0,0,0
"634",1715002,"Nova Rosalândia (TO)",0,0,0,0,0
"635",1715150,"Novo Alegre (TO)",0,0,0,0,0
"636",1715507,"Oliveira de Fátima (TO)",0,0,0,0,0
"637",1716307,"Pau D'Arco (TO)",0,0,0,0,0
"638",1716653,"Pequizeiro (TO)",0,0,0,0,0
"639",1716703,"Colméia (TO)",0,0,0,0,0
"640",1717206,"Piraquê (TO)",0,0,0,0,0
"641",1718303,"Praia Norte (TO)",0,0,0,0,0
"642",1718402,"Presidente Kennedy (TO)",0,0,0,0,0
"643",1718451,"Pugmil (TO)",0,0,0,0,0
"644",1718550,"Riachinho (TO)",0,0,0,0,0
"645",1718659,"Rio da Conceição (TO)",0,0,0,0,0
"646",1718808,"Sampaio (TO)",0,0,0,0,0
"647",1718840,"Sandolândia (TO)",0,0,0,0,0
"648",1719004,"Santa Tereza do Tocantins (TO)",0,0,0,0,0
"649",1720002,"Santa Terezinha do Tocantins (TO)",0,0,0,0,0
"650",1720200,"São Miguel do Tocantins (TO)",0,0,0,0,0
"651",1720309,"São Sebastião do Tocantins (TO)",0,0,0,0,0
"652",1720937,"Taipas do Tocantins (TO)",0,0,0,0,0
"653",1721109,"Tocantínia (TO)",0,0,0,0,0
"654",1721208,"Tocantinópolis (TO)",0,0,0,0,0
"655",1722081,"Wanderlândia (TO)",0,0,0,0,0
"656",1722107,"Xambioá (TO)",0,0,0,0,0
"657",2100204,"Alcântara (MA)",0,0,0,0,0
"658",2100436,"Alto Alegre do Maranhão (MA)",0,0,0,0,0
"659",2100550,"Amapá do Maranhão (MA)",0,0,0,0,0
"660",2100709,"Anajatuba (MA)",0,0,0,0,0
"661",2100832,"Apicum-Açu (MA)",0,0,0,0,0
"662",2100873,"Araguanã (MA)",0,0,0,0,0
"663",2101103,"Axixá (MA)",0,0,0,0,0
"664",2101251,"Bacabeira (MA)",0,0,0,0,0
"665",2101301,"Bacuri (MA)",0,0,0,0,0
"666",2101350,"Bacurituba (MA)",0,0,0,0,0
"667",2101772,"Bela Vista do Maranhão (MA)",0,0,0,0,0
"668",2101905,"Bequimão (MA)",0,0,0,0,0
"669",2101939,"Bernardo do Mearim (MA)",0,0,0,0,0
"670",2101970,"Boa Vista do Gurupi (MA)",0,0,0,0,0
"671",2102374,"Cachoeira Grande (MA)",0,0,0,0,0
"672",2102408,"Cajapió (MA)",0,0,0,0,0
"673",2102507,"Cajari (MA)",0,0,0,0,0
"674",2102606,"Cândido Mendes (MA)",0,0,0,0,0
"675",2102705,"Cantanhede (MA)",0,0,0,0,0
"676",2102754,"Capinzal do Norte (MA)",0,0,0,0,0
"677",2103109,"Cedral (MA)",0,0,0,0,0
"678",2103125,"Central do Maranhão (MA)",0,0,0,0,0
"679",2103554,"Conceição do Lago-Açu (MA)",0,0,0,0,0
"680",2103703,"Cururupu (MA)",0,0,0,0,0
"681",2103752,"Davinópolis (MA)",0,0,0,0,0
"682",2104305,"Godofredo Viana (MA)",0,0,0,0,0
"683",2104503,"Governador Archer (MA)",0,0,0,0,0
"684",2104909,"Guimarães (MA)",0,0,0,0,0
"685",2105104,"Icatu (MA)",0,0,0,0,0
"686",2105153,"Igarapé do Meio (MA)",0,0,0,0,0
"687",2105203,"Igarapé Grande (MA)",0,0,0,0,0
"688",2105401,"Itapecuru Mirim (MA)",0,0,0,0,0
"689",2105500,"João Lisboa (MA)",0,0,0,0,0
"690",2105906,"Lago Verde (MA)",0,0,0,0,0
"691",2106003,"Lima Campos (MA)",0,0,0,0,0
"692",2106201,"Luís Domingues (MA)",0,0,0,0,0
"693",2106326,"Maracaçumé (MA)",0,0,0,0,0
"694",2106375,"Maranhãozinho (MA)",0,0,0,0,0
"695",2106508,"Matinha (MA)",0,0,0,0,0
"696",2106755,"Miranda do Norte (MA)",0,0,0,0,0
"697",2106805,"Mirinzal (MA)",0,0,0,0,0
"698",2106904,"Monção (MA)",0,0,0,0,0
"699",2107100,"Morros (MA)",0,0,0,0,0
"700",2107407,"Olho d'Água das Cunhãs (MA)",0,0,0,0,0
"701",2107456,"Olinda Nova do Maranhão (MA)",0,0,0,0,0
"702",2107506,"Paço do Lumiar (MA)",0,0,0,0,0
"703",2107605,"Palmeirândia (MA)",0,0,0,0,0
"704",2108207,"Pedreiras (MA)",0,0,0,0,0
"705",2108306,"Penalva (MA)",0,0,0,0,0
"706",2108405,"Peri Mirim (MA)",0,0,0,0,0
"707",2108504,"Pindaré-Mirim (MA)",0,0,0,0,0
"708",2108801,"Pirapemas (MA)",0,0,0,0,0
"709",2109056,"Porto Rico do Maranhão (MA)",0,0,0,0,0
"710",2109205,"Presidente Juscelino (MA)",0,0,0,0,0
"711",2109239,"Presidente Médici (MA)",0,0,0,0,0
"712",2109270,"Presidente Sarney (MA)",0,0,0,0,0
"713",2109304,"Presidente Vargas (MA)",0,0,0,0,0
"714",2109452,"Raposa (MA)",0,0,0,0,0
"715",2109551,"Ribamar Fiquene (MA)",0,0,0,0,0
"716",2109601,"Rosário (MA)",0,0,0,0,0
"717",2109809,"Santa Helena (MA)",0,0,0,0,0
"718",2109908,"Santa Inês (MA)",0,0,0,0,0
"719",2110039,"Santa Luzia do Paruá (MA)",0,0,0,0,0
"720",2110203,"Santa Rita (MA)",0,0,0,0,0
"721",2110500,"São Bento (MA)",0,0,0,0,0
"722",2111003,"São João Batista (MA)",0,0,0,0,0
"723",2111029,"São João do Carú (MA)",0,0,0,0,0
"724",2111201,"São José de Ribamar (MA)",0,0,0,0,0
"725",2111300,"São Luís (MA)",0,0,0,0,0
"726",2111532,"São Pedro da Água Branca (MA)",0,0,0,0,0
"727",2111672,"São Roberto (MA)",0,0,0,0,0
"728",2111706,"São Vicente Ferrer (MA)",0,0,0,0,0
"729",2111789,"Serrano do Maranhão (MA)",0,0,0,0,0
"730",2112233,"Trizidela do Vale (MA)",0,0,0,0,0
"731",2112274,"Tufilândia (MA)",0,0,0,0,0
"732",2112407,"Turiaçu (MA)",0,0,0,0,0
"733",2112803,"Viana (MA)",0,0,0,0,0
"734",2112852,"Vila Nova dos Martírios (MA)",0,0,0,0,0
"735",5100102,"Acorizal (MT)",0,0,0,0,0
"736",5100508,"Alto Paraguai (MT)",0,0,0,0,0
"737",5100805,"Apiacás (MT)",0,0,0,0,0
"738",5101001,"Araguaiana (MT)",0,0,0,0,0
"739",5101209,"Araguainha (MT)",0,0,0,0,0
"740",5101605,"Barão de Melgaço (MT)",0,0,0,0,0
"741",5101704,"Barra do Bugres (MT)",0,0,0,0,0
"742",5103361,"Conquista D'Oeste (MT)",0,0,0,0,0
"743",5103403,"Cuiabá (MT)",0,0,0,0,0
"744",5103437,"Curvelândia (MT)",0,0,0,0,0
"745",5103452,"Denise (MT)",0,0,0,0,0
"746",5103809,"Figueirópolis D'Oeste (MT)",0,0,0,0,0
"747",5103957,"Glória D'Oeste (MT)",0,0,0,0,0
"748",5104500,"Indiavaí (MT)",0,0,0,0,0
"749",5104906,"Jangada (MT)",0,0,0,0,0
"750",5105002,"Jauru (MT)",0,0,0,0,0
"751",5105234,"Lambari D'Oeste (MT)",0,0,0,0,0
"752",5105309,"Luciara (MT)",0,0,0,0,0
"753",5105622,"Mirassol d'Oeste (MT)",0,0,0,0,0
"754",5106208,"Nova Brasilândia (MT)",0,0,0,0,0
"755",5106232,"Nova Olímpia (MT)",0,0,0,0,0
"756",5106273,"Novo Horizonte do Norte (MT)",0,0,0,0,0
"757",5106315,"Novo Santo Antônio (MT)",0,0,0,0,0
"758",5106653,"Pontal do Araguaia (MT)",0,0,0,0,0
"759",5106703,"Ponte Branca (MT)",0,0,0,0,0
"760",5106851,"Porto Estrela (MT)",0,0,0,0,0
"761",5107107,"São José dos Quatro Marcos (MT)",0,0,0,0,0
"762",5107156,"Reserva do Cabaçal (MT)",0,0,0,0,0
"763",5107198,"Ribeirãozinho (MT)",0,0,0,0,0
"764",5107206,"Rio Branco (MT)",0,0,0,0,0
"765",5107263,"Santo Afonso (MT)",0,0,0,0,0
"766",5107297,"São José do Povo (MT)",0,0,0,0,0
"767",5107404,"São Pedro da Cipa (MT)",0,0,0,0,0
"768",5107750,"Salto do Céu (MT)",0,0,0,0,0
"769",5107883,"Serra Nova Dourada (MT)",0,0,0,0,0
"770",5108204,"Torixoréu (MT)",0,0,0,0,0
"771",5108352,"Vale de São Domingos (MT)",0,0,0,0,0
"772",5108402,"Várzea Grande (MT)",0,0,0,0,0
"773",5108857,"Nova Marilândia (MT)",0,0,0,0,0
